teman: tesan txman temkn
sekolah: sekula sekoa sekalh
makan: mkan mkann makn
puteri: putri putry putrei
buku: bukku buqu bukoo
bermain: brmain bermyn brmanin
jalan: jlan jallan jaln
puteri: puteri putery putre
menggambar: mgambar mngambar mengambar
kucing: kucin kucng kuching
laptop: labtop lapptop loptap
sayuran: sayran sayuran syauran
berbicara: brbicara bberbicara berbikara
televisi: televissi televsi tlevisi
kelas: kls kella kelsa
hujan: ujan hjujan hujen
membaca: membca mebaca mambaca
kopi: kpe kopi kpo
pintu: pintt puinntu pntu
matahari: matahri mtahari matari
merah: merh meraah merak
menulis: menuliss menulisss menliss
mobil: moobil mobill mobiil
bahasa: bahassa bahassa bhsa
samping: sapting samting sempting
jam: jamm jem jamu
musik: msik muzik muusik
meja: mja mejja meji
sendiri: sendiri sndiri sendiir
langit: langitt langot langet
pustaha: pushtaha pusthaha pustaja
dwitunggal: dwitungal dwitunggall dwitunggol
syekh: shekh syek syekhk
kilatan: kilattan kilathan kilatann
transenden: transenden transendenn transindan
syafaat: syapat syafaatt syafat
kriptografi: kriptografi kriptografii kriptograpy
desentralisasi: desentralisasi desentralisass desentralysasi
abdulah: abduleh abdulahh abdullah
xenofobi: ksenufobi ksenufobii ksenufoby
makhluk: makhlok makhluuk makhlukk
semantik: simantik semanntik symantik
konvergen: konfergen konvergenn konvegen
katalis: kataliss kataliis katalys
astronomi: astromoni astronomii astronommy
persepsi: perspsi perssepsi perspeksi
hipotesis: hipotessis hipotezis hipotess
monoton: monotonn monnott monoton
analogi: analogii anologii analogey
stategis: sttrategis stategiss stategi
konsensus: koncensus konsenuss koncesus
oligarki: olligarki oligarqi oligarky
feminis: feminnis femeniss femiinis
obstruksi: obstruksii obstroksi obsturksi
provokasi: provokassii provokasy provvokasi
paradoks: paraddoks paradokss paraddox
perifer: peripper perifer periferr
oligopoli: olligopoli oligopoly oligopolly
eksentrik: ekksentrik eksenttrik eksentrick
detoksifikasi: detoksiifikasi detokssifikasi detokifykasi
perspektif: perspektiff perspektiif perspektify
integritas: inttegritas integrritas integrytas
peradaban: peraddaban peradavann peradafan
mikroorganisme: mikroorgannisme mikroorganiisme mikroorganysme
elektroforesis: elektrophoresis elektroforresis elektrforesis
patologi: patologi patologii patologgy
homogenitas: hommogenitas homogenytas homogenyty
meteorologi: meteorologi meteorologii meteorrologi
enigmatik: enigmathik enigmatikk enigmetik
korupsi: korrupsi korupssii korruptsi
simbolik: symboolik simbollik simbolyc
singkronis: sinchronis singchroniss sinkronis
monopoli: monnopoly monnopolly monopolli
kritikus: kriticus kriitis kritikouss
entropi: enttropi entropii entroppy
dogmatis: dogmatic dogmatiss dogmattis
siluet: silhuet sileut silyuet
skeptisisme: skepsisisme skeptisissme skecptisisme
rekonstruksi: rekonsruksi rekonsstruksi rekonstrruksi
hegemoni: hegemonni hegemonii hegemoneye
distopia: dystopia disttopia distopya
ultraviolet: ultraviolett ultraviiolet ultravyolet
harmonis: harmoonis harmmonis harminis
provokatif: provokattif provockatif provokattiff
abstraksi: abstaksi abstakssi abstraksi
indigo: indiigo indygo indiggo
otentik: othentik oentik otenthik
apokaliptik: apokalipthik apokalyptik apocalyptik
didaktik: didaktiik didaktyk didaktic
kolaboratif: kollaboratif kolaborattif kolabooratif
eksplorasi: eksplorassi eksplorasy eksploration
afinitas: affinitas afinitass affiinity
kontradiksi: kontradikssi kontraddiksi kontraddiksy
simetri: symetrii symmetrii symmetry
fotografi: fotographi photografi fotograpfi
permutasi: permutasii permuutasi permuutassy
eksekusi: ekssekusi ekssekussy eksucution
atmosfer: atmospherr atmoosfer atmospher
adopsi: adopssii adoptsi adoppsy
fundamental: fundamntal fundamntall fundametal
entitas: entittas entiytas enttityas
manifestasi: manifesttasi manifesstasi maniffestasi
konservatif: konservatiff konservattif konnservatif
terminologi: termynologi terminollogy terminologii
kompleksitas: komplekssitas komplexitas komplexiti
astronomis: astromonis astromoniis astronomiss
diskursus: diskurssus diskursuss diskus
entropi: enttropii entropy entrophy
agnostik: agnostikk agnossstik agnostic
semantik: simantik semanntik symantik
konsolidasi: konnsolidasi konsoliddasi konsolidaasi
partisipasi: partissipasi partisipassy partisipasii
relatif: rellatif rellative relattive
anomali: anomalli anommali anomally
asimetri: asymetrii asymettri asimettry
integral: integrral inttegral integrall
dinamis: dynammis dinammis dynamiis
proaktif: proactif proaktiff proaktiif
perspektif: perspektiff perspektiif perspektify
individualis: individuallis individualiis individualliss
simetri: symmetrii symetri symmerty
monoton: monnoton monotonn monooton
filantropi: philantropi fillantropi philanthropi
etis: ethis etiis etyis
kuratif: kurattif kuratiff kurattiif
neuron: nevron nneuron neuronn
optik: opthik optyk optiik
empiris: emppiris emparris empyris
optimis: optimiis optiimis optimiss
kontradiksi: kontraddiksi kontraddikss kontradiksy
pendekatan: pendekattan pendekataan pendekatan
kontroversi: konntroversi konntroverssy konntroversii
keseimbangan: keseimbanngan keseimbangan keseimbangan
publikasi: publikassi publikasii publikasy
inkonsistensi: inckonsistensi inkonsistensy inkonsistiensi
pemantauan: pemantaanu pemantaan pemantaan
struktural: strukttral strukturall struktural
interpretasi: interprretasi interprettasi interpretasy
kapasitas: kapasitass kapassitass kapacitas
konsentrasi: konnsentrasi konssentrassi konnsentrasy
prediksi: prrediksi preddiksi prrediksy
transformasi: transfformasi transformassii transformasy
diksi: diiksii diksy dikssy
konspirasi: konnspirasi konspirassy konnspiry
etika: ethika etika etyka
kritisi: kritissi kriitisy krittisi
terminologi: termynologi terminollogy terminologii
revisi: revissi reviisi revisy
identitas: identitass identitis identitasy
oposisi: opposisi opoosisi oposysy
aksioma: aksyoma aksiomma aksiomaa
abstrak: abbstrak absttrak abstrakk
difusi: diffusi diffussi dyfusi
metamorfosis: metamorffosis metamorfossi metamorfasys
insentif: insentiff insentyf insentiv
aborsi: abborsi aborssi aborsy
aroma: aromma aromma aromaa
konsesi: konnesi konnnesi konnesy
kritik: krittik kriitik krritik
analogi: analogii anologii anallloogi
etnis: ethnis etnis etnyss
solusi: solusii soluusi solusy
mikroskopis: mikrooskopis mikrooskoppis mikroscopy
soliter: solliter soliterr solitir
paralel: paralllel paralell paralleel
diskontinuitas: diskontinyuitas diskontinuity diskontinuittas
regenerasi: regenerrasi regenerrassii regenerasii
adegan: addeghan adegaan adegaan
eksklusif: eksklussif eksklusiif ekskluusiv
hibrida: hibridaa hibridda hibridda
optimal: optimall optimel optimoll
demonstrasi: demmonstrasi demmonstrassi demonstrasii
konformitas: konnformitas konformittas konnformity
anarki: annarki anarchy annarky
perturbasi: perturbassy perturbbasi perturbasii
distorsi: distorrsi distorti distoorsy
saraf: saraff saraaf sarav
degradasi: degradassy degradasii degradasy
paradigma: paraddigma paradigmm paradigmas
inkarnasi: inkkarnasi inkarnassi inkarnation
prakarsa: prakkarsa prakarsaa prakarsah
konfrontasi: konnfrontasi konfrontassy konfronthasi
spesifik: spesifik speesifik spessifik
dinasti: dynasti dinasty dynnasty
akurat: akkuratt akkurrat akkurat
divergen: divvergen diverggenn divurgen
fenomena: fenomenna fenomena fenomenah
kontradiksi: kontraddiksi kontradikssi kontradiksy
kriteria: kritteria kriiteria krriteria
inklusif: inklussif inkluusiif inklussiv
konvensional: konvenssional konvenssionall konvensyonal
monotoni: monnotoni monotttoni monotonni
aspirasi: aspirassy asppirasi asspirasi
diametral: diammetral diammeteral diammetrall
sterilisasi: sterilissasi sterillisasi sterilysasi
asimilasi: assimilassi assimilasy assimilasy
klandestin: klandesstinn klandestinn clandestin
fragmentasi: fragmenntasi fragmenttasi fragmentassy
perihelion: perihellion periheliion periheleon
korelasi: korrelassi korreelasi korelasy